
WE ./path_to_the_west_texture
NO ./path_to_the_north_texture
SO ./path_to_the_south_texture
EA ./path_to_the_east_texture
C    25 0 , 5,    10

F 220,100,0

        1111111111   111111 111111
        1000000000110000001100001
        1011000001110000000000001
        100100000000000000000001
111111111011000001110000000000001
100000000011000001110111111111111
11110111111111011100000010001
11110111111111011101010010W001
1100000011010101110000010001
10000000000000001100000010001
1000000000000001101010010001
110000011101010111110111100111
11110111 1110101 101111010001
11111111 1111111 11111111111