
WE ./path_to_the_west_texture
NO ./path_to_the_north_texture

F 220,100,0

SO ./path_to_the_south_texture
EA ./path_to_the_east_texture
C    250 , 5,    10

11111111111111111
10000000001100011
1111000001110001
10010000000000001
11101111011000001
10000110011100001
10000110011100001
100001100111W0001
11111111111111111