
WE ./path_to_the_west_texture.xpm
NO ./path_to_the_north_texture.xpm

F 220,100,0

SO ./path_to_the_south_texture.xpm
EA ./path_to_the_east_texture.xpm
C    250 , 5,    10

1111111111111111111111111111111111
1000000000100001000000000001000011
1001000010100111000010000101001111
1001000001101111000010000011011111
1111100N00000000001111000000011111
1001000000111000000010111111110001
1001000000001000000010000000010001
1001000000001000000010000000010001
1001000000001000000010000000010001
1001110000011000000011111111110001
1001011100111000000010111001110001
1001011100000000000010111001110001
1001011100111000000010111001110001
1001011100111000000010111001110001
1000000000000000000000000000000001
1111111111111111111111111111111111