
WE ./path_to_the_west_texture
NO ./path_to_the_north_texture

F 220,100,0

SO ./path_to_the_south_texture
EA ./path_to_the_east_texture
C    250 , 5,    10

1111111111111111111111111
1000000000110000000000001
1011000001110000000000001
1001000000000000000000001
1111111101100000111000001
1000000000110000011101111
1111111111111111111111111