NO ./images/lava.xpm

WE ./images/wall4.xpm

F 254,51,20

SO ./images/lava.xpm
EA ./images/wal.xpm

C    68,22,33

        1111111111111111111111111
        1000000000110000000000001
        1011000001110000000000001
        1001000000000000000000001
111111111011000001110000000000001
100000000011000001110111111111111
1111011111111101000000010001
1111011111111101001010010001
1100000011010101000000010001
100000000000S000000000010001
1000000000000000001010010001
11000001110101011110111100111
11110111 1110101 101111010001
11111111 1111111 111111111111