
WE ./path_to_the_west_texture.xpm
NO ./path_to_the_north_texture.xpm

F 220,100,0

SO ./path_to_the_south_texture.xpm
EA ./path_to_the_east_texture.xpm
C    250 , 5,    10

1111111111111111111111111111111111
1000000000000000000000000000000001
1000000000000000000000000000000001
1000000000000000000000000000000001
1000000000000000000000000000000001
1000000000000010100000000000000001
1000000000000000000000000000000001
10000000000000N0000000000000000001
1000000000000000000000000000000001
1000000000000000000000000000000001
1000000000000000000000000000000001
1000000000000000000000000000000001
1111111111111111111111111111111111
